#################
#               #
#     #         #
#               #
#               #
#      #        #
#           #   #
#               #
#     #         #
#          #    #
#               #
#################