^^^^^^^^^^^^^^^^^^^^^^^^^^
d    $       $       $   >
<    $   m   $   m   $   >
<    $   t   $   t   $   >
<    $   $   $   $   $   >
<    $   $   $   $   $   >
<    $   $   $   $   $   >
<    $   $   $   $   $   >
<    $   $   $   $   $   >
<    $   $   $   $   $   >
<        $       $       >
<   m    $   m   $  l    >
<        $       $       d
##########################