^^^^^^^^^^^^^^
<        m   >
<            >
d            >
<      t     >
<     tlt    d
< m    t     >
<            >
<            >
<    m       >
<            >
##############