#######################
#..........+..........#
#.....................#
#.......#######.......#
#.......#.....#.......#
+.......#..#..#.......+
#.......#.....#.......#
#.......#######.......#
#.....................#
#..........+..........#
#######################