##########################
#         ########       #
#                        #
# ########               #
#                        #
#                   #    #
#   ########        #    #
#                   #    #
#        ####       #    #
#                        #
##########################