^^^^^^^^^^^^^^^^^^^^^^^^^^
d    $       $       $   >
<    $       $   m   $   >
<    $   t   $       $   >
<    $   $   $   $   $   >
<    $   $   $   $   $   >
<    $   $   $   $   $   >
<    $   $   $   $   $   >
<    $   $   $   $   $   >
<    $   $   $   $   $   >
<        $       $       >
<   m    $   l   $       >
<        $       $       d
##########################