^^^^^^^^^^^^^^^^^^^^^^^^^^
d   $$                   >
<   tm                   >
<       $$      $$       >
<       $$      $$       >
<       $$      $$       >
<          mlm           >
<       $$      $$       >
<       $$      $$       >
<       $$      $$       >
<       $$      $$       >
<       $$      $$       d
<       $$      $$       >
<                        >
<          mmm           >
##########################