^^^^^^^^^^^^^^^^^^^^^^^^^^
d   $$                   >
<                        s
<       $$      $$       >
<       $$      $$       >
<       $$      $$       >
<   m       t            >
<       $$      $$       >
<       $$      $$       >
<                        >
<       $$      $$       >
<                        >
<                        d
##########################