##########################
#   ##                   #
#                        #
#       ##      ##       #
#       ##      ##       #
#       ##      ##       #
#                        #
#       ##      ##       #
#       ##      ##       #
#                        #
#       ##      ##       #
#                        #
#                        #
##########################