#######################
#..........+..........#
#.#######.#####.#######
#.#.....#.....#.#.....#
#.#.###.#####.#.#.###.#
#...#.#.....#.#...#.#.#
###.#.#####.#.#####.#.#
#...#.....#.#.....#...#
#.#######.#.#####.###.#
#.........#...K...#...#
#######################