#######################
#..........+..........#
#..####.........####..#
#..#..#..~~~~~..#..#..#
#..####..~~~~~..####..#
#.......~~~~~~~.......#
#..####..~~~~~..####..#
#..#..#..~~~~~..#..#..#
#..####.........####..#
#..........+..........#
#######################