^^^^^^^^^^^^^^^^^^^^^^^^^^
<  m                     d
<       $                >
<        $               >
<         $     m        >
<          $             >
<           $            >
<            $           >
<             $          >
<              $         >
<               $        >
d                $       >
<           t            >
##########################