#######################
#..........+..........#
#.^^^^^^^^^^^^^^^^^^^.#
#.^.....#######.....^.#
#.^.....#..T..#.....^.#
+.^.....#.....#.....^.+
#.^.....#######.....^.#
#.^.................^.#
#.^^^^^^^^^^^^^^^^^^^.#
#..........+..........#
#######################