^^^^^^^^^^^^^^^^^^^^^^^^^^
d   $$                   >
<                        >
<       $$      $$       >
<       $$      $$       >
<       $$      $$       >
<          tlt           >
<       $$      $$       >
<       $$      $$       >
<                        >
<       $$      $$       >
<                        >
<                        d
##########################