^^^^^^^^^^^^^^^^^^^^^^^^^^
<    $       $       $   >
<    $       $       $   >
<    $       $       $   >
<    $   $   $   $   $   >
<    $   $   $   $   $   >
<    $   $   $   $   $   >
<    $   $   $   $   $   >
<    $   $   $   $   $   >
<    $   $   $   $   $   >
<        $       $       >
<   m    $   l   $       >
<        $       $       >
&&&&&&&&&&&&&&&&&&&&&&&&&&