^^^^^^^^^^^^^^^^^^^^^^^^^^
<                        >
<    $$$$$$$$$$$$$$$$$   >
<    $     lllll     $   >
<    $               $   >
<    $$$$$$$   $$$$$$$   >
<                        >
&&&&&&&&&&&&&&&&&&&&&&&&&&