^^^^^^^^^^^^^^^^^^^^^^^^^^
<   $$                   >
<                        >
<       $$      $$       >
<       $$      $$       >
<       $$      $$       >
<          tlt           >
<       $$      $$       >
<       $$      $$       >
<                        >
<       $$      $$       >
<                        >
<                        >
&&&&&&&&&&&&&&&&&&&&&&&&&&