^^^^^^^^^^^^^^^^^^^^^^^^^^
d    $       $       $   >
<    $       $       $   >
<    $       $       $   >
<    $   $   $   $   $   >
<    $   $   $   $   $   >
<    $   $   $   $   $   >
<    $   $   $   $   $   >
<    $   $   $   $   $   >
<    $   $   $   $   $   >
<        $       $       >
<   m    $   l   $       >
<        $       $       d
&&&&&&&&&&&&&&&&&&&&&&&&&&