^^^^^^^^^^^^^^
<        m   >
<            >
<            >
<      t     >
<     tlt    >
< m    t     >
<            >
<            >
<    m       >
<            >
&&&&&&&&&&&&&&