^^^^^^^^^^^^^^^^^
<               >
<     $    m    >
<  m            >
<               >
<      $        >
<           $   >
<        m      >
<     $         >
<          $    >
<  m            >
&&&&&&&&&&&&&&&&&