#######################
#                     #
#                     #
#       #######       #
#       #     #       #
#       #  #  #       #
#       #     #       #
#       #######       #
#                     #
#          #          #
#######################