^^^^^^^^^^^^^^^^^^^^^^^
<          m          >
<                     >
<       $$$$$$$       >
<       $     $       >
d       $  $  $       d
<       $     $       >
<       $$$$$$$       >
<                     >
s          m          >
&&&&&&&&&&&&&&&&&&&&&&&