^^^^^^^^^^^^^^^^^^^^^^^^^^
<    $       $       $   >
<    $   m   $   m   $   >
<    $   t   $   t   $   >
<    $   $   $   $   $   >
<    $   $   $   $   $   >
<    $   $   $   $   $   >
<    $   $   $   $   $   >
<    $   $   $   $   $   >
<    $   $   $   $   $   >
<        $       $       >
<   m    $   m   $  l    >
<        $       $       >
&&&&&&&&&&&&&&&&&&&&&&&&&&