^^^^^^^^^^^^^^^^^^^^^^^^^^
<  m                     d
<       $            m   >
<        $               >
<         $     m        >
<          $             >
<           $l           >
<     $      $           >
<      $      $          >
<       $      $         >
<        $      $    m   >
d                $       >
<           t            >
&&&&&&&&&&&&&&&&&&&&&&&&&&