^^^^^^^^^^^^^^^^^
<               >
d     $    m    >
<  m            >
<               >
<      $        >
<           $   >
<        m      >
<     $         >
<          $    d
<  m            >
&&&&&&&&&&&&&&&&&