^^^^^^^^^^^^^^^^^^^^^^^^^^
<   $$                   >
<                        >
<  m    $$      $$       >
<       $$      $$       >
<       $$      $$       >
<               t        >
<       $$      $$       >
<       $$      $$       >
<   t           m        >
<       $$      $$       >
<                        >
<           l            >
&&&&&&&&&&&&&&&&&&&&&&&&&&