!!!!!!!!!!!!!!!!!!!!!!!!!!
?AAA^^AAAAAAAAAAAAAAAAAAA$
?AAAtgAAAAAAAAAAAAAAAAAAA$
?AAAAAAA%%AAAAAA%%AAAAAAA$
?AAAAAAA%%AAAAAA%%EAAAAAA$
?AAAAAAA%%AAAAAA%%AAAAAAA$
?AAAAAAABBAglgAABCAAAAAAA$
?AAAAAAA%%AAsAAA%%AAAAAAA$
?AAAAAAA%%AAAAAA%%AAAAAAA$
?AAAAAAA%%AAAAAA%%AAAAAAA$
?AAAAAAD%%AAAAAA%%AAAAAAA$
?AAAAAAA%%AAAAAA%%AAAAAAA$
?AAAAAAA%%EEEEEE%%AAAAAAA$
?AAAAAAAAAAAAAAAAAAAAAAAA$
?AAAAAAAAAAgggAAAAAAAAAAA$
@@@@@@@@@@@@@@@@@@@@@@@@@@