!!!!!!!!!!!!!!!!!!!!!!!!!!
?AAgAAAAAAAAAAAAAAAAAAAAA$
?AAAAAAA^AAAAAAAAAAAAAsAA$
?AAsAAAAA%AAAAAAAAAAAAAAA$
?AAAAAAAAA%EAAAAgAAAAAAAA$
?AAAAAAAAAA%AAAAAAAAAAAAA$
?AAAAAAAAAAD%AAAAAAAAAAsA$
?AAAAAAAAAAAAuAAAAAAAAAAA$
?AAAgAAAAAAAAA%AAAAAAAAAA$
?AAAAAAAAAAAAAA%AAAAAAAAA$
?AAAAAAsAAAAAAAA5AAAAACAA$
?AAAAAAAAAAAAAAAA^AAAAAAA$
?AAAAAAAAAAAtAAAAAAAAAAAA$
@@@@@@@@@@@@@@@@@@@@@@@@@@