!!!!!!!!!!!!!!!!!!!!!!!!!!
?AAA%%AAAAAAAAAAAAAAAAAAD$
?AAAAAAAAAAAAAAAAAAAAAAgA$
?AAgAAAA^^AAAAAA^^AAAAAAA$
?AAAAAAA^^AAAAAA^^AAAAAAA$
?AAAAAAA^^AAAAAA^^AAAAAAA$
?AAAAAAAAAAAAAAAtAAAAAAAA$
?AAAABAA^^AAAAAA^^AAAAAAA$
?AAACAAA^^AAsAAA^^AAAAAAA$
?AAAtAAAAAAAAAAAgAAAAAAAA$
?AAAAAAA^^AAAAAA^^AAAAAAA$
?AAAAAAAAAAAAAAAAAEAAAAAA$
?AAAAAgAAAAAlAAAADAAAAAAA$
@@@@@@@@@@@@@@@@@@@@@@@@@@