!!!!!!!!!!!!!!!!!!!!!!!!!!
?AAAAABBAA%%%%%%%%AAAAAAA$
?AAAAAACAAAAAAAAAAAAAAAAA$
?A%%%%%%%%AAAAgAAAAAAAAAA$
?AAAAAAAAAgAAAAAAAAAAAAAA$
fAAAAAAAAAAAAAAAAAAA^AAAA$
?AAA%%%%%%%%AAAAAAAA^lAAA$
?AAAAAAAAAAAAAAAABAA^AAAA$
?AAgAAAAA%%%%AAAAABA^AAAA$
?AAgAAAAAAAAAAAAsAABAgAAA$
@@@@@@@@@@@@@@@@@@@@@@@@@@