^^^^^^^^^^^^^^^^^^^^^^^^^^
<  m                     >
<       $            m   >
<        $               >
<         $     m        >
<          $             >
<           $            >
<     $      $           >
<      $      $          >
<       $      $         >
<        $      $    m   >
<                $       >
<           t            s
&&&&&&&&&&&&&&&&&&&&&&&&&&