!!!!!!!!!!!!!!!!!!!!!!!!!!
?AAAAAAAAA^^^^^^^^AAAAAAA$
?AAAAAAAAAAAAAAAAAAAAAAAA$
?A^^^^^^^%AAAAgAAAAAAAAAA$
?AAAAAAAAAAAAAABAAAAAAAAA$
UAAAAAAAAAAAAAAAAAAA%AAAA$
?AAA%^^^^^^^DAAAsAAA%lAAA$
?AAAAAAAAAAAAAAAAAAA%AAAA$
?EAgAAAAA^^^^AAAAAAA%AAAA$
?AAAAAAAAAAAgAAAAAAAAAAEA$
@@@@@@@@@@@@@@@@@@@@@@@@@@