^^^^^^^^^^^^^^^^^^^^^^^^^^
<  m                     >
<       $                >
<        $               >
<         $     m        >
<          $             >
<           $            >
<            e           >
<             $          >
<              $         >
<               $        >
<                $       >
<           t            >
&&&&&&&&&&&&&&&&&&&&&&&&&&