^^^^^^^^^^^^^^^^^^^^^^^^^^
<   $$                   >
<   tm                   >
<       $$      $$       >
<       $$      $$       >
<       $$      $$       >
<          mlm           >
<       $$      $$       >
<       $$      $$       >
<       $$      $$       >
<       $$      $$       >
<       $$      $$       >
<       $$      $$       >
<                        >
<          mmm           >
&&&&&&&&&&&&&&&&&&&&&&&&&&