^^^^^^^^^^^^^^^^^^^^^^^^^^
<    $       $       $   >
<    $       $   m   $   >
<    $   t   $       $   >
<    $   $   $   $   $   >
<    $   $   $   $   $   >
<    $   $   $   $   $   >
<    $   $   $   $   $   >
<    $   $   $   $   $   >
<    $   $   $   $   $   >
<        $       $       >
<   m    $   l   $       >
<        $       $       >
&&&&&&&&&&&&&&&&&&&&&&&&&&