^^^^^^^^^^^^^^^^^^^^^^^^^^
<         $$$$$$$$       >
<                        >
d $$$$$$$$    m          >
<                        >
s                   $    >
<   $$$$$$$$        $l   >
<                   $    >
<  m     $$$$       $    >
<                        >
&&&&&&&&&&&&&&&&&&&&&&&&&&