^^^^^^^^^^^^^^^^^^^^^^^^^^
d   $$                   >
<                        >
<  m    $$      $$       >
<       $$      $$       >
<       $$      $$       >
<               t        >
<       $$      $$       >
<       $$      $$       >
<   t           m        >
<       $$      $$       d
<                        >
<           l            >
&&&&&&&&&&&&&&&&&&&&&&&&&&