^^^^^^^^^^^^^^^^^^^^^^^^^^
<  m                     >
<       $            m   >
<        $               >
<         $     m        >
<          $             >
<           $l           >
<     $      $           >
<      $      $          >
<       $      $         >
<        $      $    m   >
<                $       >
<           t            >
&&&&&&&&&&&&&&&&&&&&&&&&&&