^^^^^^^^^^^^^^^^^^^^^^^^^^
<   $$                   >
<                        >
<       $$      $$       >
<       $$      $$       >
<       $$      $$       >
<           m            >
<       $$      $$       >
<       $$      $$       >
<                        >
<       $$      $$       >
<                        >
<                        >
&&&&&&&&&&&&&&&&&&&&&&&&&&