^^^^^^^^^^^^^^^^^^^^^^^^^^
<   $$                   >
<                        s
<       $$      $$       >
<       $$      $$       >
<       $$      $$       >
<   m       t            >
<       $$      $$       >
<       $$      $$       >
<                        >
<       $$      $$       >
<                        >
<                        >
&&&&&&&&&&&&&&&&&&&&&&&&&&